NO assets/textures/bark.xpm
SO assets/textures/pizzapizz.xpm
WE assets/textures/durumdurum.xpm
EA assets/textures/fbenech.xpm
D assets/textures/door.xpm

F 220,100,0
C 225,30,0

            1111111111111111111111111
            1000000000110000000000001
            1011000001110000000000001
            1100000000000000000000001
1111111111110000011100000000000011111
10000000001100000111D11111D111111
1111D111111111D11100000010001
1111D111111111011101010010001
11000000110101011100000010001
10000000000000001100000010001
100000000000000011010100D0001
11000001110101011111011110N0011
11110111 1110101 101111010001
11111111 1111111 111111111111
