NO ./textures/bark.xpm
SO ./textures/bark.xpm
WE ./textures/bark.xpm
EA ./textures/bark.xpm
F 300,100,0
C 225,-30,999

111111
1000N1
111111
