NO textures/bark.xpm
SO	textures/pizzapizz.xpm
WE textures/durumdurum.xpm
EA textures/bark.xpm

D textures/door.xpm
F 220,100,0
C 225,30,0

            1111111111111111111111111
            1000000000110000000000001
            1011000001110000000000001
            110000000000000000D000001
1111111111110000011100000000000011111
100000000011000001110111111111111
11110111111111011100000010001
11110111111111011101010010D01
11000000110101011100000010D01
100000D00000D0001100000010001
1000D0000D00000011010100D0001
11000001110101011111011110N0011
11110111 1110101 101111010001
11111111 1111111 111111111111
