NO textures/bark.xpm
SO textures/pizzapizz.xpm
WE textures/durumdurum.xpm
EA textures/bark.xpm

F 123,123,125
C 0,0,255

1111111111111111
10W0100000000001
1010000000000001
1000000000000001
1111111111111111
