	NO ./cub3d
		SO ./cub3d
WE ./cub3d
						  EA ./cub3d



F 255,255,255
C 20,255,255



11111111110
