ok pas si mal
ouais c'est		fine




freeok


11111111110
