NO ./cub3d
		SO ./cub3d
       WE ./cub3d
		EA ./cub3d

F 255,255,0
C 20,255,255

1111111111111111
10W0100000000001
1010000000000001
1000000000000001
1111111111111111
