	NO ./cub3d
		SO ./cub3d

F 0,-25,0



11111111110
