NO ./textures/bark.xpm
NO ./textures/bark.xpm
SO ./textures/bark.xpm
WE ./textures/bark.xpm
EA ./textures/bark.xpm
F 220,100,0
F 200,50,0
C 225,30,0

111111
1000N1
111111
