NO ./textures/bark.xpm
SO ./textures/bark.xpm
WE ./textures/bark.xpm
EA ./textures/bark.xpm
F 220,100,0
C 225,30,0

1111111
1000001
100000N
1111111
