NO ./textures/bark.xpm
SO ./textures/bark.xpm
WE ./textures/bark.xpm
EA ./textures/bark.xpm
F 220,100,0
C 225,30,0

111111
1X@#N1
1$%^&1
111111
