NO ./textures/bark.xpm
SO ./textures/bark.xpm
WE ./textures/bark.xpm
EA ./textures/bark.xpm
F 220,100,0
C 225,30,0

111
10001
1N1
111111
1001
111
